GameTitle=StarCraft II
EditorTitle=StarCraft II Editor
PTRSuffix= PTR
PublicTestSuffix= Public Test
DownloadProgressMessage=Preparing game data
DownloadProgressCancel=Cancel
DownloadProgressCreatingFiles=Creating files %CURRENT% / %TOTAL%
DownloadProgressCalculating=Calculating...
DownloadProgressApplyingPatches=Applying patches %CURRENT% / %TOTAL%
DownloadProgressDownloadingKB=Downloading %CURRENT% KB / %TOTAL% KB
DownloadProgressDownloadingMB=Downloading %CURRENT% MB / %TOTAL% MB
DownloadProgressDownloadingSuffixKBPreSec=  (%RATE% KB/s)
DownloadProgressDownloadingSuffixMBPreSec=  (%RATE% MB/s)
DownloadProgressExtractingKB=Extracting %CURRENT% KB / %TOTAL% KB
DownloadProgressExtractingMB=Extracting %CURRENT% MB / %TOTAL% MB
FileExtractionError=Failed to create required files. If your hard drive is full, try freeing up space and restarting StarCraft II. If that doesn't work, you may need to reinstall the game.
OperatingSystemNotSupportedMessage=Your operating system is not supported by StarCraft II.
OperatingSystemNotSupportedTitle=Error
StreamingServerConnectCancelButton=Cancel
StreamingServerConnectFailure=Failed to initialize game data streaming system.
StreamingServerConnectNoCacheMfil=Unable to prepare game data for offline play. To play offline, you must first run StarCraft II once while connected to the internet. Please check your internet connection and try again.
StreamingServerOfflineNotLocal=Unable to download game data from Blizzard's servers. Please check your internet connection and try again later.
MessageBoxYesButton=Yes
MessageBoxNoButton=No
MessageBoxSaveButton=Save
MessageBoxDiscardButton=Don't Save
MessageBoxAcceptButton=OK
MessageBoxCancelButton=Cancel
WaitForScanAndRepairMessage=Waiting for Scan and Repair to complete.
WaitForScanAndRepairExitButton=Exit
