DownloadProgressApplyingPatches=正在应用补丁  %CURRENT% / %TOTAL% /// Applying patches %CURRENT% / %TOTAL%
DownloadProgressCalculating=正在计算…… /// Calculating...
DownloadProgressCancel=取消 /// Cancel
DownloadProgressCreatingFiles=正在创建文件 %CURRENT% / %TOTAL% /// Creating files %CURRENT% / %TOTAL%
DownloadProgressDownloadingKB=正在下载 %CURRENT% KB / %TOTAL% KB /// Downloading %CURRENT% KB / %TOTAL% KB
DownloadProgressDownloadingMB=正在下载 %CURRENT% MB / %TOTAL% MB /// Downloading %CURRENT% MB / %TOTAL% MB
DownloadProgressDownloadingSuffixKBPreSec=  (%RATE% KB/s) ///   (%RATE% KB/s)
DownloadProgressDownloadingSuffixMBPreSec=  (%RATE% MB/s) ///   (%RATE% MB/s)
DownloadProgressExtractingKB=正在提取 %CURRENT% KB / %TOTAL% KB /// Extracting %CURRENT% KB / %TOTAL% KB
DownloadProgressExtractingMB=正在提取 %CURRENT% MB / %TOTAL% MB /// Extracting %CURRENT% MB / %TOTAL% MB
DownloadProgressMessage=正在准备游戏数据 /// Preparing game data
EditorTitle=《星际争霸II》编辑器 /// StarCraft II Editor
FileExtractionError=创建所需文件失败。如果您的硬盘已满，尝试释放更多的空间并重启《星际争霸II》。如果问题仍然存在，您可能需要重新安装游戏。 /// Failed to create required files. If your hard drive is full, try freeing up space and restarting StarCraft II. If that doesn't work, you may need to reinstall the game.
GameTitle=《星际争霸II》 /// StarCraft II
MessageBoxAcceptButton=确认 /// OK
MessageBoxCancelButton=取消 /// Cancel
MessageBoxDiscardButton=放弃保存 /// Don't Save
MessageBoxNoButton=否 /// No
MessageBoxSaveButton=保存 /// Save
MessageBoxYesButton=遵命 /// Yes
OperatingSystemNotSupportedMessage=《星际争霸II》不支持你的操作系统。 /// Your operating system is not supported by StarCraft II.
OperatingSystemNotSupportedTitle=错误 /// Error
PTRSuffix= PTR ///  PTR
PublicTestSuffix= 公共测试 ///  Public Test
StreamingServerConnectCancelButton=取消 /// Cancel
StreamingServerConnectFailure=启动游戏数据流系统失败。 /// Failed to initialize game data streaming system.
StreamingServerConnectNoCacheMfil=无法准备离线游戏所需的数据。如需进行离线游戏，您必须先在联网时运行《星际争霸II》。请检查您的网络连接并重试。 /// Unable to prepare game data for offline play. To play offline, you must first run StarCraft II once while connected to the internet. Please check your internet connection and try again.
StreamingServerOfflineNotLocal=无法从暴雪服务器下载游戏数据。请检查网络连接并稍后再试。 /// Unable to download game data from Blizzard's servers. Please check your internet connection and try again later.
WaitForScanAndRepairExitButton=退出 /// Exit
WaitForScanAndRepairMessage=正在等待完成扫描和修复。 /// Waiting for Scan and Repair to complete.
